Allo?
arthuro
20
15
11111o0p111111111111
1111om1l000001111111
111om100000000111111
11om1000000000011111
1om10000000000001111
1s100000000000000111
11000000000000000011
100000000000000000j1
10000000000000000011
11000000000000000111
11100000000000001111
11110000000000011111
11111000000000111111
11111100000001111111
11111111111111111111

