Basique
Arthuro
10
5
1111111111
10001s0001
10j0110001
1000000001
1111111111

