C++
Arthuro
20
15
00000000100010000000
o001000000100m100010
00000001000000010010
000001000000010o0m11
00000000110000000111
001000000s0000000111
00001000000000001111
0000p011000000011111
01000000000000011111
01010000000000100001
l0000000000000001001
00110100000m01110001
00010000000101100j01
00001100001101100001
00000000111101111111
