CoffreFort
arthuro
20
15
11111111111111111111
1000000000000001o0p1
10c00000000000000001
10010000000000000001
10000000000000001001
10100001111000000001
1000j0001s1000000001
1010000000000011l001
10000000000000001001
10100000000000000001
100000000000000d1001
110000000000ml000001
1o000000101111100001
1l000000000000000001
111111111l00000m1111

