Dissimulation
arthuro
20
15
11111111111111111111
1s100000000000000001
1000000000000i001101
10000000000000001101
100001i0000000111001
1ii00000000000101001
10i00000000000101001
10i001000000001i1001
10i00i00000000001001
10000100000000001001
10010000011100001001
1000000000j001001001
10000000000000001001
10000000000000o000m1
1111111111111lm11111
