Glados
arthuro
25
20
111sopop11111100111111111
100000000001000000i000001
1000000000010000000000i01
1000000000010i0000i0iii01
i000000000000i0000ii00001
1000000000i1ii00000000ii1
1010000000010000i00i0i001
1000mlml00010000i00000001
11111op11111110111d111111
1o0000000001o0000000p0001
10o0000001010000000000001
1lm00000000100o0000000000
11100000c0010000000000011
1000000000010100000000000
1000000000010000000o0p001
1000000000000100100010001
1100100000010100000l0p001
1100000j10010101000000m11
110000000001l000000000001
1111111111111101111111111
