Gluten
arthuro
20
15
11111111111111111111
10000010000001111111
10000010110000000111
10000000100000010111
11100010100000000111
1s100010100000000111
101100000000000000p1
1lp10000000000000101
1om1000000j000000101
10110000000000001101
10100100000000001101
10100000000000101101
10111110111111101101
1l0000000000000000m1
1111111l0000000m1111


