Oxion
arthuro
20
15
111111111111o0p11111
10000000000100000001
100000001000000s1101
11000000000001000101
10000000000000t00101
10000000000001000001
10100000000000000001
10001000000000000011
1000000000t000000001
10000000000000000001
11010000000000000001
10010001000000000001
100000o0000000000001
100000ml0000000000j1
1111111111lm11011111
