Premier pas
Arthuro
10
10
1111111111
1s00000001
1111111101
1110000101
1000000101
1000000101
1000000001
110j000101
1100000101
1111111111

