Triquadrant
Arthuro
20
15
111111111111s1111111
1o000000000p0o00p101
1l000010000000000101
11000000000000000101
100000000000t0000001
10000000001000000001
10000000000000010001
10000001000000000001
100000t0000001000001
10001100000000000001
o0100100010000000001
l0000100000000001001
10010000000000111001
1lm100000000000j0001
11111111111111111111
