belle arnaque
DeinDall
20
10
111111111111111o00p1
1000001000110000o0j1
10101000001000000011
101s1000000000000111
10101000000000000001
10101100000101010001
10100000000001010001
10111111111111010001
1000000000000001l0m1
11111111111111111111


