Gears Wins Enable Nods
Qual
15
20
iiiiiiiiiiiiiii
ij00000000000pi
i1000000001110i
i0000000001110i
i00010i0i0i110i
i01000i0i0i000i
i00000i0i0i000i
i00100i0i0i000i
i00011i1i0i000i
i0101sd0000010i
i0001110i0ici0i
i0010010om10i0i
i0000010lp10i0i
i010001l0m10i0i
i00000111110i0i
i00100000000i0i
i0000iiiiiiii0i
i0101001010100i
il00000000000mi
iiiiiiiiiiiiiii
