Anguleux
arthuro
15
15
111111111111111
1o00000000000p1
100s000000p0001
100000000000001
100000001000001
1l0000000100001
111111110000101
1o0p1op10000001
1010100100000m1
1010000100000p1
1l0000000000001
1110000110000m1
100010011100001
10000j0111lm111
111111111111111
