Collissimo
arthuro
20
15
11111111111111111111
1j000000000000000001
10001000010000110001
10000000000000s10001
10000000000000110001
10000001000000000101
10000000000000000011
10000000001000000001
10110000000010000001
10001000100000000001
10000000000000000001
10000000000000001001
10000000000000010001
10010000000010000001
11111111111111111111

