Danger
arthuro
20
16
00001000000010000000
00000000000000000000
0000001000000s000000
00000000010000100000
00010000000000000000
00000001000000000000
00000001001100000000
000010000j0100000000
00011000000100000000
00000000000000000000
000000000i0000000000
00000000000000000000
00001000001000001000
00001100100000011000
00000000000000100000
00000000010000000000

