Inibition
Arthuro
20
15
11111110000011111011
11110000000011111d11
oddd0000000001111d11
010100j0000001111d11
lp010000000001111d11
s0m11111110001100011
om111000100001001011
0111100c100001000001
01111000100001001c01
0110d00000000d00d0cd
11001000000001001c01
1d00d00000000100d0cd
1111111100000d001c01
11111111111111d11001
11001001001001001111
