Mule
Arthuro
10
10
o000p11111
lc11000001
1100000001
110000c011
1000000dds
1000100000
1000000001
1110000001
11101000j1
1111111111
