Vortexit
arthuro
20
15
o0000000t000000o000p
0111111000000000000m
0110011l0000000j0000
01000010000000000000
01000010000011111111
010000000000d001o0p1
01c1lm11l00p100000m1
011s1111o0001010t001
00000000000000000001
01000000100011l00001
01000000100011111111
01000000000000000000
0100i000100000000000
01111111100000000000
l000000000000000000m

